......B....
......B....
...........
......B....
.......B.ll
.o....wbb.l
.cCc..CcC.l
bc.cc..bb.l
