...........
...........
...........
...........
...........
...........
X.w.c.B..cX
XXXXXXX.XXX
