...........
...........
...........
...........
....B..XXl.
Xc..B..XXl.
XXX.XXXXXl.
XXX.X.w..l.
