...........
...........
...........
..BB.......
..bb.......
c.XXXXXXXl.
X........l.
X......w.lX
