...........
....C....B.
....b.lXlll
...l.l.....
...l.l.....
...l.l.....
Xw.l.l.....
.XXl.l.....
