l..........
l..........
lB.........
lb.........
lB.c.......
lb.X.......
l...B.w..cX
l.lbXXXX.XX
