.Bc........
lBl........
lb.bb......
lX.........
l....B.....
XXl..XX....
..l......c.
.wl......X.
