l..........
l.B....B...
llllbblll..
l..........
l..........
l..........
l..C..C....
lw.b..b....
