...........
...........
...........
...........
...........
.Xw.o.B..c.
.XXXXXX.XXX
.XXXXXX.XXX
