...........
...........
...........
.....B.....
.....c.c...
....llXXX..
.....l....c
..l..oBw..X
