w.B........
XXX........
o.......c..
XXXX.l..X..
....XXXXX..
...........
...........
...........
