...lB......
...lc......
...lB......
...lc......
...lcCCCC..
...lB......
...lXXXXX..
...l.w.....
