XBBccoccVVX
XccBcccBccX
XcccBcBcccX
XBBccBccBBX
XccBcccBccX
XcccBcBcccX
XccccBccccX
wccccccccc.
