w..........
...........
C.........
.CXX.......
C.l.XX.....
CC..l.XX..b
.CC...l.XXX
CC........C
