l.........w
lX.........
lX.........
lX.........
lX.........
lX.....XXXX
lB.....l..c
XOX....X..X
