..........o
X..........
X..........
X..........
X..........
X......XXXX
b......l..c
WX.....X..X
