XC........w
X.XXXXXXXXX
X.X........
X.X........
X.X........
C.X........
X.X........
ol........c
