...........
...........
...........
..B.......w
X.XXXXXXXXX
..l........
o.lb......c
bb.........
